1111111111111111111111
100G000000000000000101
10000000100000000000C1
1001000000000000000001
10C10100000C0100000101
1001000000001100010001
1E000C001P000000000001
1001000010000100C00001
1100000010000000000101
1000100000000000000C01
1000000000000000C00001
10000000000000C00C0001
1000000C10001100000101
101G000000000100100001
1000000001001000000001
1111111111111111111111
