111111111111111111111111111111
1P0000000000000000000000000001
101111111111110000000011100001
100000000000000GGG110000000001
100000000000000000110000000001
100000000001000000000100000001
101111110001110110GGG1001G0001
100000000000000000000111110001
101111110000100000000100000001
101E000100001000000000000000G1
10100G0100001001111111100000G1
1010000100001000000000000000G1
1010000100001GG1111111100G0001
100000GG0000100CCGCC0000000001
1000001100001001100001100000G1
100000110000100000000000000001
1GG00000000G100000000000000001
1111111111111111111111111111G1
101010101010111111111111111111
111111111111111111111111111111
