1111111111111111111111111
1G10101011111111101010101
11111111CCCCCCCCC11111111
1PCCCCCCCCCCCCCCCCCCCCCE1
11111111CCCCCCCCC11111111
1010101011111111101010101
1111111111111111111111111
