1111111111111111111111111
1000111G000000000G1111111
11111111CCCCCCCCC11111111
1PCCCCCCCCCCCCCCCCCCCCCE1
11111111CCCCCCCCC11111111
1110000000000000111111111
1111111111111111111111111
