1111111111
1000100001
1001000001
1100000101
1001010001
1000000011
1000011001
1100000001
10E0000001
1111111111
